4 -100 100 100 100 500 100 500 100 100 100
4 -150 100 100 100 500 100 500 100 100 100
4 -200 100 100 100 500 100 500 100 100 100
4 -250 100 100 100 500 100 500 100 100 100
4 -300 100 100 100 500 100 500 100 100 100
4 -350 100 100 100 500 100 500 100 100 100
4 -400 100 100 100 500 100 500 100 100 100
4 -450 100 100 100 500 100 500 100 100 100
4 -500 100 100 100 500 100 500 100 100 100
4 -550 100 100 100 500 100 500 100 100 100
4 -600 100 100 100 500 100 500 100 100 100
4 -650 100 100 100 500 100 500 100 100 100
4 -700 100 100 100 500 100 500 100 100 100
4 -750 100 100 100 500 100 500 100 100 100
4 -800 100 100 100 500 100 500 100 100 100
4 -850 100 100 100 500 100 500 100 100 100